16
*
16
*
1
*
00-1-0
#
01-1-1
#
02-1-2
#
03-1-6
#
04-1-7
#
05-1-10
#
06-1-16
#
07-1-37
#
08-1-50
*
1111111111000000
1111000000000000
1111000000000000
1111000000000000
1111000000000000
0000000000000000
0000000000000000
0000000000000000
0000000000000000
0000000000000000
0000000000000000
0000000000000000
0000000000000000
0000000000000000
0000000000000000
0000000000000000
*
01 01 01 01 01 01 01 01 01 01 06 02 02 05 00 08
01 01 01 01 04 03 03 03 03 03 07 02 02 05 00 00
01 01 01 01 06 02 02 02 02 02 02 02 02 05 00 08
01 01 01 01 06 02 02 02 02 02 02 02 02 05 00 00
01 01 01 01 06 02 02 02 02 02 02 02 02 05 00 08
03 03 03 03 07 02 02 02 02 02 02 02 02 05 00 00
02 02 02 02 02 02 02 02 02 02 02 02 02 05 00 08
02 02 02 02 02 02 02 02 02 02 02 02 02 05 00 00
02 02 02 02 02 02 02 02 02 02 02 02 02 05 00 08
02 02 02 02 02 02 02 02 02 02 02 02 02 05 00 00
02 02 02 02 02 02 02 02 02 02 02 02 02 05 00 08
02 02 02 02 02 02 02 02 02 02 02 02 02 05 00 00
02 02 02 02 02 02 02 02 02 02 02 02 02 05 00 08
02 02 02 02 02 02 02 02 02 02 02 02 02 05 00 00
02 02 02 02 02 02 02 02 02 02 02 02 02 05 00 08
02 02 02 02 02 02 02 02 02 02 02 02 02 05 00 00
*
15-15
*
15-0-1