32
*
32
*
1
*
00-1-0
#
01-1-1
#
02-1-2
#
03-1-6
#
04-1-7
#
05-1-10
#
06-1-11
#
07-1-16
#
08-1-31
#
09-1-37
#
10-1-41
#
11-1-50
#
12-1-66
*
11111111110000000000011111111111
11110000000000000000011111111111
11110000000000000000000000111111
11110000000000000000000000111111
11110000000000000000000000111111
00000000000000000000000000111111
00000000000000000000000000000111
00000000000000000000000000000111
00000000000000000000000000000000
00000000000000000000000000000000
00000000000000000000000000000000
00000000000000000000000000000000
00000000000000000000000000000000
00000000000000000000000000000000
00000000000000000000000000000000
00000000000000000000000000000000
00000000000000000000000000000000
00000000000000000000000000000000
00000000000000000000000000000000
00000000000000000000000000000000
00000000000000000000000000000000
00000000000000000000000000000000
00000000000000000000000000000000
00000000000000000000000000000000
00000000000000000000000000000000
00000000000000000000000000000000
00000000000000000000000000000000
00000000000000000000000000000000
00000000000000000000000000000000
00000000000000000000000000000000
00000000000000000000000000000000
00000000000000000000000000000000
*
01 01 01 01 01 01 01 01 01 01 07 02 02 05 00 11 00 12 02 02 06 01 01 01 01 01 01 01 01 01 01 01
01 01 01 01 04 03 03 03 03 03 09 02 02 05 00 00 00 12 02 02 06 01 01 01 01 01 01 01 01 01 01 01
01 01 01 01 07 02 02 02 02 02 02 02 02 05 00 11 00 12 02 02 10 03 03 03 03 08 01 01 01 01 01 01
01 01 01 01 07 02 02 02 02 02 02 02 02 05 00 00 00 12 02 02 02 02 02 02 02 06 01 01 01 01 01 01
01 01 01 01 07 02 02 02 02 02 02 02 02 05 00 11 00 12 02 02 02 02 02 02 02 06 01 01 01 01 01 01
03 03 03 03 09 02 02 02 02 02 02 02 02 05 00 00 00 12 02 02 02 02 02 02 02 06 01 01 01 01 01 01
02 02 02 02 02 02 02 02 02 02 02 02 02 05 00 11 00 12 02 02 02 02 02 02 02 10 03 03 08 01 01 01
02 02 02 02 02 02 02 02 02 02 02 02 02 05 00 00 00 12 02 02 02 02 02 02 02 02 02 02 06 01 01 01
02 02 02 02 02 02 02 02 02 02 02 02 02 05 00 11 00 12 02 02 02 02 02 02 02 02 02 02 10 03 03 03
02 02 02 02 02 02 02 02 02 02 02 02 02 05 00 00 00 12 02 02 02 02 02 02 02 02 02 02 02 02 02 02
02 02 02 02 02 02 02 02 02 02 02 02 02 05 00 11 00 12 02 02 02 02 02 02 02 02 02 02 02 02 02 02
02 02 02 02 02 02 02 02 02 02 02 02 02 05 00 00 00 12 02 02 02 02 02 02 02 02 02 02 02 02 02 02
02 02 02 02 02 02 02 02 02 02 02 02 02 05 00 11 00 12 02 02 02 02 02 02 02 02 02 02 02 02 02 02
02 02 02 02 02 02 02 02 02 02 02 02 02 05 00 00 00 12 02 02 02 02 02 02 02 02 02 02 02 02 02 02
02 02 02 02 02 02 02 02 02 02 02 02 02 05 00 11 00 12 02 02 02 02 02 02 02 02 02 02 02 02 02 02
02 02 02 02 02 02 02 02 02 02 02 02 02 05 00 00 00 12 02 02 02 02 02 02 02 02 02 02 02 02 02 02
02 02 02 02 02 02 02 02 02 02 02 02 02 05 00 11 00 12 02 02 02 02 02 02 02 02 02 02 02 02 02 02
02 02 02 02 02 02 02 02 02 02 02 02 02 05 00 00 00 12 02 02 02 02 02 02 02 02 02 02 02 02 02 02
02 02 02 02 02 02 02 02 02 02 02 02 02 05 00 11 00 12 02 02 02 02 02 02 02 02 02 02 02 02 02 02
02 02 02 02 02 02 02 02 02 02 02 02 02 05 00 00 00 12 02 02 02 02 02 02 02 02 02 02 02 02 02 02
02 02 02 02 02 02 02 02 02 02 02 02 02 05 00 11 00 12 02 02 02 02 02 02 02 02 02 02 02 02 02 02
02 02 02 02 02 02 02 02 02 02 02 02 02 05 00 00 00 12 02 02 02 02 02 02 02 02 02 02 02 02 02 02
02 02 02 02 02 02 02 02 02 02 02 02 02 05 00 11 00 12 02 02 02 02 02 02 02 02 02 02 02 02 02 02
02 02 02 02 02 02 02 02 02 02 02 02 02 05 00 00 00 12 02 02 02 02 02 02 02 02 02 02 02 02 02 02
02 02 02 02 02 02 02 02 02 02 02 02 02 05 00 11 00 12 02 02 02 02 02 02 02 02 02 02 02 02 02 02
02 02 02 02 02 02 02 02 02 02 02 02 02 05 00 00 00 12 02 02 02 02 02 02 02 02 02 02 02 02 02 02
02 02 02 02 02 02 02 02 02 02 02 02 02 05 00 11 00 12 02 02 02 02 02 02 02 02 02 02 02 02 02 02
02 02 02 02 02 02 02 02 02 02 02 02 02 05 00 00 00 12 02 02 02 02 02 02 02 02 02 02 02 02 02 02
02 02 02 02 02 02 02 02 02 02 02 02 02 05 00 11 00 12 02 02 02 02 02 02 02 02 02 02 02 02 02 02
02 02 02 02 02 02 02 02 02 02 02 02 02 05 00 00 00 12 02 02 02 02 02 02 02 02 02 02 02 02 02 02
02 02 02 02 02 02 02 02 02 02 02 02 02 05 00 11 00 12 02 02 02 02 02 02 02 02 02 02 02 02 02 02
02 02 02 02 02 02 02 02 02 02 02 02 02 05 00 00 00 12 02 02 02 02 02 02 02 02 02 02 02 02 02 02
*
15-15
*
15-0-2